{
	"entities": [],
	"layer": [
		{
			"name": "brick",
			"width": 30,
			"height": 20,
			"linkWithCollision": false,
			"visible": true,
			"tilesetName": "media/walls_19color.jpg",
			"repeat": false,
			"preRender": false,
			"distance": "1",
			"tilesize": 32,
			"foreground": false,
			"data": [
				[1,1,1,1,1,1,1,1,1,1,1,1,1,1,1,1,1,1,1,1,1,1,1,1,1,1,1,1,1,1],
				[1,0,0,0,1,0,1,0,0,0,0,0,1,0,0,0,0,0,0,0,0,0,0,0,0,0,0,0,0,1],
				[1,0,0,0,1,0,1,0,0,0,0,0,1,0,1,1,1,1,1,1,1,0,1,0,0,0,0,0,0,1],
				[1,0,0,0,1,0,1,0,0,0,0,0,1,0,1,0,0,0,0,0,0,0,1,0,0,0,0,0,0,1],
				[1,0,0,0,0,0,0,0,0,0,0,0,1,0,1,0,1,1,1,1,1,0,1,0,0,0,0,0,0,1],
				[1,1,1,1,1,0,1,0,0,0,0,0,1,0,1,0,0,0,0,0,0,0,1,0,0,0,0,0,0,1],
				[1,0,0,0,1,0,1,0,0,0,0,0,1,0,1,0,1,1,1,1,1,1,1,1,1,1,1,1,1,1],
				[1,0,0,0,0,0,1,0,0,0,0,0,1,0,1,0,0,0,0,0,0,0,1,0,0,0,0,0,0,1],
				[1,0,0,0,1,0,1,0,0,0,0,0,1,0,1,1,1,1,1,1,1,0,1,0,1,1,1,1,1,1],
				[1,0,0,0,1,0,1,0,0,0,0,0,1,0,1,0,0,0,0,0,0,0,1,0,0,0,0,0,0,1],
				[1,0,0,0,1,0,1,0,0,0,0,0,1,0,1,1,0,0,0,1,1,1,1,1,1,0,0,0,0,1],
				[1,0,0,0,1,0,1,0,0,0,0,0,0,0,0,0,1,0,0,1,0,0,0,0,0,0,0,0,0,1],
				[1,0,0,0,1,0,1,1,1,1,1,1,1,1,1,0,1,0,0,1,0,0,0,0,1,0,0,0,0,1],
				[1,0,0,0,1,0,1,0,0,0,0,0,0,0,1,0,1,1,1,1,0,0,0,0,1,0,0,0,0,1],
				[1,0,0,0,0,0,1,0,0,0,0,0,0,0,1,0,1,0,0,0,0,0,0,0,1,0,0,0,0,1],
				[1,1,1,1,1,0,1,0,0,0,0,0,0,0,1,0,1,0,0,0,0,0,0,0,1,0,0,0,0,1],
				[1,0,0,0,0,0,0,0,0,0,0,0,0,0,1,0,1,1,0,0,0,0,0,0,1,0,0,0,0,1],
				[1,1,1,1,1,0,1,1,0,0,0,0,0,0,1,0,0,1,0,0,0,0,0,0,1,0,0,0,0,1],
				[1,0,0,0,0,0,0,1,0,0,0,0,0,0,1,0,0,0,0,0,0,0,0,0,1,0,0,0,0,1],
				[1,1,1,1,1,1,1,1,1,1,1,1,1,1,1,1,1,1,1,1,1,1,1,1,1,1,1,1,1,1]
			]
		},
		{
			"name": "floor",
			"width": 30,
			"height": 20,
			"linkWithCollision": false,
			"visible": true,
			"tilesetName": "media/browntiles.png",
			"repeat": false,
			"preRender": false,
			"distance": "1",
			"tilesize": 32,
			"foreground": false,
			"data": [
				[0,0,0,0,0,0,0,0,0,0,0,0,0,0,0,0,0,0,0,0,0,0,0,0,0,0,0,0,0,0],
				[0,727,727,727,0,727,0,974,974,974,974,974,0,727,746,746,746,746,746,746,746,746,746,746,746,746,746,746,746,0],
				[0,727,727,727,0,727,0,926,926,926,926,974,0,727,0,0,0,0,0,0,0,746,0,746,746,746,746,746,746,0],
				[0,727,727,727,0,727,0,926,926,926,729,729,0,727,0,746,746,746,746,746,746,746,0,746,746,746,746,746,746,0],
				[0,727,727,727,746,727,746,926,926,926,729,729,0,727,0,746,0,0,0,0,0,746,0,746,746,746,746,746,746,0],
				[0,0,0,0,0,727,0,926,926,926,729,729,0,727,0,746,746,746,746,746,746,746,0,746,746,746,746,746,746,0],
				[0,727,727,727,0,727,0,926,926,926,729,729,0,727,0,746,0,0,0,0,0,0,0,0,0,0,0,0,0,0],
				[0,727,727,727,746,727,0,926,926,926,729,729,0,727,0,746,746,746,746,746,746,746,0,746,746,746,746,746,746,0],
				[0,727,727,727,0,727,0,926,926,926,729,729,0,727,0,0,0,0,0,0,0,746,0,746,0,0,0,0,0,0],
				[0,727,727,727,0,727,0,926,926,926,729,729,0,727,0,746,746,746,746,746,746,746,0,746,746,746,746,746,746,0],
				[0,727,727,727,0,727,0,926,926,926,729,729,0,727,0,0,746,746,746,0,0,0,0,0,0,746,746,746,746,0],
				[0,727,727,727,0,727,0,926,926,926,729,729,727,727,746,746,0,746,746,0,746,746,746,746,974,746,746,746,746,0],
				[0,727,727,727,0,727,0,0,0,0,0,0,0,0,0,746,0,746,746,0,746,746,746,746,0,746,746,746,746,0],
				[0,727,727,727,0,727,0,746,746,746,746,746,746,746,0,746,0,0,0,0,746,746,746,746,0,746,746,746,746,0],
				[0,727,727,727,746,727,0,746,746,746,746,746,746,746,0,746,0,746,746,746,746,746,746,746,0,746,746,746,746,0],
				[0,0,0,0,0,727,0,746,746,746,746,746,746,746,0,746,0,746,746,746,746,746,746,746,0,746,746,746,746,0],
				[0,727,727,727,746,746,746,746,746,746,746,746,746,746,0,746,0,0,746,746,746,746,746,746,0,746,746,746,746,0],
				[0,0,0,0,0,746,0,0,746,746,746,746,746,746,0,746,746,0,746,746,746,746,746,746,0,746,746,746,746,0],
				[0,727,727,727,727,727,727,0,746,746,746,746,746,746,0,746,746,746,746,746,746,746,746,746,0,746,746,746,746,0],
				[0,0,0,0,0,0,0,0,0,0,0,0,0,0,0,0,0,0,0,0,0,0,0,0,0,0,0,0,0,0]
			]
		}
	]
}